C  130,  199, 255
NO ./textures/red.xpm
SO ./textures/bookshelf.xpm
EA ./textures/leavests.xpm
WE ./textures/bricks.xpm

F 34,139,34



1111111111111111111111111111111111
1100000000010010010010000000000011
11000000N0000000000000000000000011
1100000000000000000000110000000011
110000000000000000000000000000000000000000000000000001111
11110000000100001000000000000000000000000000000000000011111
1100000000000000000000010000000011
1100000000010000000000000000011111
1100000000000000100000000000000001
1100000000000001110000000000000011
11000000000000     000000000000011
110000000000001      000000000000011
110000000000000000000000011
1100000000000000000000000011
1111111111111111111111111111111111



